                         ----- End
                         |
                         |
    X  X  X  X  X  X  X     X  X
    X           X              X
    X     X              X     X
    X     X     X  X  X  X  X  X
    X     X           X        X
    X  X  X  X  X           X  X
    X     X           X        X
    X     X  X  X  X  X  X     X
    X                          X
    X  X  X  X  X  X  X  X  |  X
                            |
                  Start -----