          ----- Start
          |
          |
    X  X     X  X  X  X  X  X  X
    X           X              X
    X     X           X     X  X
    X     X     X  X           X
    X     X        X     X     X
    X     X  X  X           X  X
    X     X           X        X
    X     X     X  X  X  X  X  X
    X     X                    X
    X  X  X  X  X  X  X  X  |  X
                            |
                End     -----